1111111111111111111111111111111111111111
1P00000000000000000000000000000000000001
1000000000000000000000000000000000000001
1000000111111111111111111110000000000001
1000000000000000000000000C10000000000001
1000000000000000000000000010000000000001
1000000111111111111110000010000000000001
1000000000000000000C10000010000000000001
1000000011111111111110000010000000000001
1000000010000000000000000010000000000001
100000001C000000000000000010000000000001
1000000011111111111111111110000000000001
1000000000000000000000000000000000000001
1000000000000000000000000000000000000001
1000000000000000000000000000000000000001
1000000000000000000000000000000000000001
1000000000000000000000000000000000000001
1000000000000000000000000000000000000111
1000000000000000000000000000000000000101
10000000000000000000000000000000000010E1
1111111111111111111111111111111111111111