1111111111111111111111111111111111111111
1P000000C000C00000000000C000000000000001
1000010100100000101001000000010100000001
1000001010101000100100000001010000000001
1E000000000000C0000000000000000000C00001
1111111111111111111111111111111111111111