1111111111111
1P100000000C1
1010010000001
100001E000001
1111111111111