1111111111111111111111111
1P011E000000C000000000C11
1001111111111111111110011
1C01100110011000000110011
1001100110011111100110C11
1001100000011000000110011
1001111110011001111110011
1001111110011000000110011
1C01111111111111111110011
1000000C0000000000000C011
1111111111111111111111111